XXXXXXXXXXXXXXXXXXXXXXXXXXXXXXXXXXXXXXXXXXXXXXXXXXXXXXXXXXXXXXXX
X..............................XX..............................X
X..............................XX..............................X
X.......S......................XX..............................X
X..............................XX..............................X
X..............................XX..............................X
X..............................................................X
X..............................XX..............................X
X..............................XX..............................X
X..............................XX..............................X
X..............................XX..............................X
X..............................XX..............................X
X..............................XX..............................X
X..............................XX..............................X
X..............................XX..............................X
X..............................................................X
X..............................XX..............................X
X..............................................................X
X..............................................................X
X..............................XX..............................X
X..............................................................X
X..............................................................X
X..............................................................X
X..............................................................X
X..............................XX..............................X
X..............................XX..............................X
X..............................XX..............................X
X..............................XX..............................X
X..............................XX..............................X
X..............................................................X
X..............................................................X
X..............................................................X
X..............................................................X
X..............................................................X
X..............................................................X
XXXXXXXXXXXXXXXXXXXXXXXXXXXXXXXXXXXXXXXXXXXXXXXXXXXXXXXXXXXXXXXX