AAAAXXXXXXXXXXXXXXXXXXXXXXXXXXXXXXXXXXXXXXXXXXXXXXXXXXXXXXXXXXXXXXXXXAAAAAAXAAAAAAXAAAAAAAAAAAAAAAAAAAAAAAAAAAA
AAAAX.....X.....X.....X.....XAAAX.....X.....X.....X.....X.....X.....XAAAAAAXAAAAAAXAAAAAAAAAAAAAAAAAAAAAAAAAAAA
AAAAX.....X.....X.....X.....XAAAX.....X.....X.....X.....X.....X.....XAAAAAAXAAAAAAXAAAAAAAAAAAAAAAAAAAAAAAAAAAA
AAAAX.....X.....X.....X.....XAAAX.....X.....X.....X.....X.....X.....XAAAAAAXAAAAAAXAAAAAAAAAAAAAAAAAAAAAAAAAAAA
AAAAX.....X.....X.....X.....XAAAX.....X.....X.....X.....X.....X.....XAAAAAAXAAAAAAXAAAAAAAAAAAAAAAAAAAAAAAAAAAA
AAAAX.....X.....X.....X.....XAAAX.....X.....X.....X.....X.....X.....XAAAAAAXAAAAAAXAAAAAAAAAAAAAAAAAAAAAAAAAAAA
AAAAX.....X.....X.....X.....XAAAX.....X.....X.....X.....X.....X.....XAAAAAAXAAAAAAXAAAAAAAAAAAAAAAAAAAAAAAAAAAA
XXXXX..XXXXXXX..X..XXXX..XXXXXXXXXXX..XXXX..XXXX..XXXX..XXXX..XXXX..XXXXXXXXXXXXXXXAAAAAAAAAAAAAAAAAAAAAAAAAAAA
X.................................................................................XAAAAAAAAAAAAAAAAAAAAAAAAAAAA
X....................2............................................................XAAAAAAAAAAAAAAAAAAAAAAAAAAAA
X................1................................................................XXXXXXXXXXXXXXXXXXXXXXXXXXXXX
X.............................................................................................................X
X.............................................................................................................X
XXXXXXX..XXXXXXX..X..XXXXXXXXXXXX.....XXXXXXXXX..XX..XXXXXXXXXXXXXXXXXXXXXX...................................X
X........X........X...X.........X.....X.....X....X.....XAAAAAAAAAAAAAAAAAAX...................................X
X........X........X...X.........X...........X....X.....XAAAAAAAAAAAAAAAAAAX...................................X
X........X........X...X.........X...........XXXXXX.....XAAAAAAAAAAAAAAAAAAX.......XXXXXXXXX..X..XXXXXXXXX.....X
X........X........X...X.........X.....XXXXXXXAAAAX.....XAAAAAAAAAAAAAAAAAAX.......X..........X..........X.....X
X........X........X...X.........X...........XAAAAXXXXXXXAAAAAAAAAAAAAAAAAAX.......X..........X..........X.....X
XXXXXXXXXXXXXXXXXXXXXXX.....................XAAAAAAAAAAAAAAAAAAAAAAAAAAAAAX.......X..........X..........X.....X
AAAAAAAAAAAAAAAAAAAAAAX...............X.....XAAAAAAAAAAAAAAAAAAAAAAAAAAAAAX.......X..........X..........X.....X
AAAAAAAAAAAAAAAAAAAAAAXXXXXXXXXXX.....XXXXXXXAAAAAAAAAAAAAAAAAAAAAAAAAAAAAX.......X..........X..........X.....X
AAAAAAAAAAAAAAAAAAAAAAX.........X.....XAAAAAAAAAAAAAAAAAAAAAAAAAAAAAAAAAAAX.......X..........X..........X.....X
AAAAAAAAAAAAAAAAAAAAAAX.........X.....XAAAAAAAAAAAAAAAAAAAAAAAAAAAAAAAAAAAX..................X................X
AAAAAAAAAAAAAAAAAAAAAAX.........X.....XAAAAAAAAAAAAAAAAAAAAAAAAAAAAAAAAAAAX..................X................X
AAAAAAAAAAAAAAAAAAAAAAX.........X.....XAAAAAAAAAAAAAAAAAAAAAAAAAAAAAAAAAAAX.......XXXXXXXX..XXX..XXXXXXXX.....X
AAAAAAAAAAAAAAAAAAAAAAX...............XAAAAAAAAAAAAAAAAAAAAAAAAAAAAAAAAAAAX.................XAX...............X
AAAAAAAAAAAAAAAAAAAAAAX...............XAAAAAAAAAAAAAAAAAAAAAAAAAAAAAAAAAAAX.................XAX...............X
AAAAAAAAAAAAAAAAAAAAAAXXXXXXXXXXX.....XAAAAAAAAAAAAAAAAAAAAAAAAAAAAAAAAAAAX.......X.........XAX.........X.....X
AAAAAAAAAAAAAAAAAAAAAAX.........X.....XAAAAAAAAAAAAAAAAAAAAAAAAAAAAAAAAAAAX.......X.........XAX.........X.....X
AAAAAAAAAAAAAAAAAAAAAAX.........X.....XAAAAAAAAAAAAAAAAAAAAAAAAAAAAAAAAAAAX.......X.........XAX.........X.....X
AAAAAAAAAAAAAAAAAAAAAAX.........X.....XAAAAAAAAAAAAAAAAAAAAAAAAAAAAAAAAAAAX.......X.........XAX.........X.....X
AAAAAAAAAAAAAAAAAAAAAAX.........X.....XAAAAAAAAAAAAAAAAAAAAAAAAAAAAAAAAAAAX.......X.........XAX.........X.....X
AAAAAAAAAAAAAAAAAAAAAAX...............XAAAAAAAAAAAAAAAAAAAAAAAAAAAAAAAAAAAX.......X.........XAX.........X.....X
AAAAAAAAAAAAAAAAAAAAAAX...............XAAAAAAAAAAAAAAAAAAAAAAAAAAAAAAAAAAAX.......X.........XAX.........X.....X
AAAAAAAAAAAAAAAAAAAAAAXXXXXXXXXXX.....XAAAAAAAAAAAAAAAAAAAAAAAAAAAAAAAAAAAX.......XXXXXXXX..XXX..XXXXXXXX.....X
AAAAAAAAAAAAAAAAAAAAAAX.........X.....XAAAAAAAAAAAAAAAAAAAAAAAAAAAAAAAAAAAX.......
AAAAAAAAAAAAAAAAAAAAAAX...............XAAAAAAAAAAAAAAAAAAAAAAAAAAAAAAAAAAAX.......
AAAAAAAAAAAAAAAAAAAAAAX......X........XAAAAAAAAAAAAAAAAAAAAAAAAAAAAAAAAAAAX.......
AAAAAAAAAAAAAAAAAAAAAAXXXXXXXXXXX.....XAAAAAAAAAAAAAAAAAAAAAAAAAAAAAAAAAAAX.......
AAAAAAAAAAAAAAAAAAAAAAX......X........XAAAAAAAAAAAAAAAAAAAAAAAAAAAAAAAAAAAX.......
AAAAAAAAAAAAAAAAAAAAAAX...............XAAAAAAAAAAAAAAAAAAAAAAAAAAAAAAAAAAAX.......
AAAAAAAAAAAAAAAAAAAAAAX.........X.....XAAAAAAAAAAAAAAAAAAAAAAAAAAAAAAAAAAAX.......
AAAAAAAAAAAAAAAAAAAAAAXXXXXXXXXXX.....XAAAAAAAAAAAAAAAAAAAAAAAAAAAAAAAAAAAX.......
AAAAAAAAAAAAAAAAAAAAAAX.........X.....XAAAAAAAAAAAAAAAAAAAAAAAAAAAAAAAAAAAX.......
AAAAAAAAAAAAAAAAAAAAAAX.........X.....XAAAAAAAAAAAAAAAAAAAAAAAAAAAAAAAAAAAX.......
AAAAAAAAAAAAAAAAAAAAAAX.........X.....XAAAAAAAAAAAAAAAAAAAAAAAAAAAAAAAAAAAX.......
AAAAAAAAAAAAAAAAAAAAAAX.........X.....XAAAAAAAAAAAAAAAAAAAAAAAAAAAAAAAAAAAX.......
AAAAAAAAAAAAAAAAAAAAAAX.........X.....XAAAAAAAAAAAAAAAAAAAAAAAAAAAAAAAAAAAX.......
AAAAAAAAAAAAAAAAAAAAAAX...............XAAAAAAAAAAAAAAAAAAAAAAAAAAAAAAAAAAAX.......
AAAAAAAAAAAAAAAAAAAAAAX...............XAAAAAAAAAAAAAAAAAAAAAAAAAAAAAAAAAAAX.......
AAAAAAAAAAAAAAAAAAAAAAXXXXXXXXXXX.....XAAAAAAAAAAAAAAAAAAAAAAAAAAAAAAAAAAAX.......
